luscious - говоря про природу, очень зеленый и привлекательный; восхитительный

a plaza - открытая площадка или площадь в городе, особенно в испаноязычных странах; площадь

to  - прыгать или быстро двигаться, чтобы поймать или удержать что-то; набрасываться

a trigger finger - палец, который используется для стрельбы из пистолета; указательный палец

a moniker - имя или прозвище

to subjugate - победить народ или страну и управлять ими таким образом, чтобы не давать им никакой свободы; порабощать

scarce - нелегко находимый или получаемый; дефицитный

a chaplain - христианский чиновник, отвечающий за религиозные нужды организации; капеллан

a hoopla - большое внимание общественности к событию или деятельности; шумиха

a doohickey - любой маленький предмет, название которого вы не можете вспомнить; штуковина

to call the shots - быть в состоянии принимать решения, которые повлияют на ситуацию; командовать

white-knuckle - заставляющее вас чувствовать себя очень напуганным и часто возбужденным

to cower - опускать голову или тело в страхе, часто при движении назад; съеживаться

to put something in mothballs - перевести что-то в состояние хранения или в резерв

a quagmire - ситуация, которая может легко загнать вас в ловушку, так что вы окажетесь втянуты в проблемы, 
от которых трудно уйти

forth - вперед, откуда-то

a facetiousness - состояние несерьёзности по отношению к серьёзному предмету, в попытке казаться смешным или умным

savvy - имеющие или демонстрирующие практические знания и опыт; подкованный

deluded - введенный в заблуждение или сбитый с толку

coy - намеренно держащий что-то в секрете; скромный

a tomfoolery - дурачество

a peril - опасность

godspeed - используется для пожелания удачи кому-то, отправляющемуся в путешествие

a rotunda - здание или его часть круглой формы, часто имеющее купол наверху; ротонда

wily - говоря про человека, умный, очень хорошо понимающий ситуации, возможности и людей, и часто готовый использовать 
уловки для достижения цели; коварный

a finesse - большое мастерство или стиль; мастерство

a guise - появление кого-либо или чего-либо, особенно с целью обмана

a dusk - сумерки

to dwindle - стать меньше по размеру или количеству; сокращаться

a brawn - физическая сила и большие мышцы; мускулы

a lumber mill - лесопилка

a seepage - процесс, при котором жидкость медленно вытекает из отверстия или через что-либо; утечка

to impend - говоря про события, обычно неприятные или нежелательные, надвигаться

woozy - чувствующий себя слабым или больным и неспособным ясно мыслить; одурманенный