---------------------------------------------------------------------------------------------------------------------------------------------------
------------------------------------------------------------------- ARTIFACTS ---------------------------------------------------------------------
---------------------------------------------------------------------------------------------------------------------------------------------------

---------------------------------------------------------------- Butterfly knife ------------------------------------------------------------------

a quirk - необычная привычка или часть чьей-то личности, или что-то странное и неожиданное; причуда, бзик

a necessety - протребность в чем-то

----------------------------------------------------------------- Propaganda flyer ----------------------------------------------------------------

to distribute - распространять

to reign - говоря про государство, править

----------------------------------------------------------------- Hood ornament earring ------------------------------------------------------------

an earring - серьга

a fair size/amount/number/bit/distance - изрядное количество чего-то

a disuse - неиспользование

impracticality - непрактичность

------------------------------------------------------------------------ Shang ----------------------------------------------------------------------

a district - район

a supplier - поставщик

---------------------------------------------------------------------- Exam guide --------------------------------------------------------------------

a resident - резидент, проживающий

designated - назначенный

---------------------------------------------------------------------- Lemon tree ---------------------------------------------------------------------

to cultivate - культивировать

---------------------------------------------------------------------- Credit card --------------------------------------------------------------------

to revert - возвращаться к чему-то

a currency - валюта

-------------------------------------------------------------------- Architect bust ----------------------------------------------------------------------

a passage of time - течение времени

to crop up - возникать

a populace - население, народ

to worship - поклоняться

an embodiment - воплощение чего-то