a remorse - раскаяние

derelict - заброшенный

to gaze - долго смотреть на что-то или кого-то, особенно с удивлением или восхищением, или потому, что думаешь о чем-то другом

to surmise - предпологать

a demise - смерть; кончина

network of supermarkets/chain of supermarkets - сеть супермаркетов

savage - дикий/жестокий

to dial - говоря про номер телефона, набирать

beyond - говоря про какие-то характеристики или лимиты, превышающее; более чем

a numeracy - способность заниматься базовой математикой

a serfdom - крепостное право

a trapezoid - трапеция

confident - уверенный

a jug band - небольшая группа исполнителей, играющих джаз, блюз или народную музыку на очень простых музыкальных инструментах, 
особенно использующих в качестве инструментов такие предметы, как пустые кувшины

a shank - длинная, тонкая, прямая часть определенных объектов, особенно та, которая соединяет конец устройства или инструмента, который вы держите; хвостовик

a farewell - прощание

a tithe - десятина

faint - слабый; говоря про далние объекты, маленький

lucid - ясный; понятный

majestic - величественный

a rover - вездеход

overt - явный; видный

consequently - следовательно

out of earshot - так, что бы никто не услышал

vapid - банальный

charismatic - харизматичный

a purge - очистка; удаление

to prowl - красться

a negotiation - переговоры

a juxtaposition - сопостовление

a value - значение

a desiderium - сильная тоска, особенно по чему-то, что было утеряно

a fudge - мягкая сладость, приготовленная из сахара, масла и молока